34 14
14 14 14 14 14 14 14 14 14 14 14 14 14 14 14 14 14 14 14 14 14 14 14 14 14 14 14 14 14 14 14 14 14 14
14 14 14 14 14 14 14 14 14 14 14 14 14 14 14 14 14 14 14 14 14 14 14 14 14 14 14 14 14 14 14 14 14 14
14 14 14 14 14 14 14 14 14 14 14 14 14 14 14 14 14 14 14 14 14 14 14 14 14 14 14 14 14 14 14 14 14 14
14 14 14 14 14 14 14 14 14 14 14 14 14 14 14 14 14 14 14 14 14 14 14 14 14 14 14 14 14 14 14 14 14 14
14 14 14 14 14 16 17 14 14 14 14 14 14 14 14 14 14 14 14 14 14 14 16 17 14 14 14 14 14 14 16 17 14 14
14 14 14 14 14 14 14 14 14 14 14 14 14 14 16 17 14 14 14 14 14 14 14 14 14 14 14 14 14 14 14 14 14 14
16 17 14 14 14 14 14 14 14 14 14 14 14 14 14 14 14 14 14 14 14 14 14 14 14 14 14 14 14 14 14 14 14 14
14 14 14 14 14 14 14 14 14 14 14 14 14 14 14 14 14 26 27 27 28 14 14 14 14 14 14 14 14 14 14 14 18 14
14 14 14 14 14 14 14 14 14 26 27 27 28 14 14 14 14 14 14 14 14 14 14 14 14 26 27 28 14 21 14 14 19 14
14 14 14 14 14 14 14 12 14 14 14 14 14 14 14 14 14 14 14 14 14 14 9 14 14 21 18 14 14 22 14 14 19 14
15 14 14 14 14 14 14 10 24 14 18 24 22 9 24 14 14 14 14 14 14 14 13 14 14 22 19 14 14 22 24 14 19 15
15 14 14 14 14 4 5 11 25 14 20 25 23 11 25 14 14 4 5 14 14 14 11 14 14 23 20 4 5 23 25 14 20 15
1 1 1 1 1 1 1 1 1 1 1 1 1 1 1 1 1 1 1 1 1 1 7 8 7 6 6 7 8 6 7 8 6 8
0 0 0 0 0 0 0 0 0 0 0 0 0 0 0 0 0 0 0 0 0 0 0 0 0 0 0 0 0 0 0 0 0 0