34 14
27 27 27 27 27 27 27 27 27 27 27 27 27 27 27 27 27 27 27 27 27 27 27 27 27 27 27 27 27 27 27 27 27 27
27 27 27 27 27 27 27 27 27 27 27 27 27 27 27 27 27 27 27 27 27 27 27 27 27 27 27 27 27 27 27 27 27 27
27 27 27 27 27 27 27 27 27 27 27 27 27 27 27 27 27 27 27 27 27 27 27 27 27 27 27 27 27 27 27 27 27 27
27 52 53 27 27 27 27 27 27 27 27 27 27 27 27 27 27 27 52 53 27 27 27 27 27 27 27 27 27 27 27 27 27 27
27 27 27 27 27 27 27 27 27 27 27 27 27 27 27 27 27 27 27 27 27 27 27 27 27 27 27 27 27 27 27 27 27 27
27 27 27 27 27 27 27 27 27 27 52 53 27 27 27 27 27 27 27 27 27 27 27 27 27 27 27 27 27 27 52 53 27 27
27 27 27 49 50 50 51 27 33 34 27 27 27 27 27 27 27 27 27 27 27 27 27 27 33 34 27 27 27 27 27 27 27 27
27 27 27 27 27 27 27 27 35 36 27 27 27 27 30 27 27 27 49 50 50 51 27 27 35 36 27 49 50 51 27 27 27 27
27 27 43 27 27 30 27 27 35 36 27 27 27 27 31 27 44 27 27 27 27 27 27 43 35 36 27 27 27 30 27 27 27 27
27 27 45 27 27 31 27 27 35 36 27 50 50 50 31 27 46 27 27 27 27 27 27 47 35 36 27 27 27 31 27 27 27 27
27 27 46 27 27 31 41 27 35 36 27 27 27 27 31 27 45 37 39 37 39 41 27 46 35 36 37 39 37 31 27 27 27 27
27 27 48 27 27 32 42 27 35 36 27 27 27 27 32 27 48 38 40 38 40 42 27 48 35 36 38 40 38 32 27 27 27 27
29 29 29 29 29 29 29 29 29 29 29 29 29 29 29 29 29 29 29 29 29 29 29 29 29 29 29 29 29 29 29 29 29 29
28 28 28 28 28 28 28 28 28 28 28 28 28 28 28 28 28 28 28 28 28 28 28 28 28 28 28 28 28 28 28 28 28 28