34 14
29 29 29 29 29 29 29 29 29 29 29 29 29 29 29 29 29 29 29 29 29 29 29 29 29 29 29 29 29 29 29 55 56 29
29 29 29 29 29 29 29 29 29 29 29 29 29 29 29 29 29 29 29 29 29 29 29 29 29 29 29 29 29 29 29 29 29 29
55 56 29 29 29 29 29 29 29 29 29 29 29 29 29 29 29 29 29 29 29 29 29 29 29 29 29 29 29 29 29 29 29 29
29 29 29 29 29 29 29 29 29 29 29 29 29 29 29 55 56 29 29 29 29 29 29 29 29 29 29 29 29 29 29 29 29 29
29 29 29 29 29 29 29 29 29 29 29 29 29 29 29 29 29 29 29 29 29 29 29 29 29 29 29 29 29 29 29 29 29 29
29 29 29 29 29 29 29 55 56 29 29 29 29 29 29 29 29 29 29 29 29 29 29 29 55 56 29 29 29 29 29 29 29 29
29 29 29 29 29 29 36 37 29 29 29 29 29 29 29 29 29 29 29 29 29 29 29 29 29 29 29 29 29 29 29 52 53 54
29 52 53 54 29 29 38 39 29 29 29 29 29 29 29 29 52 53 54 29 29 29 29 29 36 37 29 29 29 36 37 29 29 29
29 29 33 29 29 29 38 39 52 53 54 29 46 29 29 29 29 33 29 29 47 29 29 29 38 39 53 53 33 38 39 29 29 29
30 29 34 29 29 29 38 39 29 29 29 29 49 29 29 29 29 34 29 29 49 29 29 29 38 39 29 29 34 38 39 29 29 30
30 29 34 29 29 29 38 39 40 42 40 42 48 29 44 29 29 34 29 29 50 40 42 40 38 39 40 42 34 38 39 29 29 30
30 29 35 29 29 29 38 39 41 43 41 43 51 29 45 29 29 35 29 29 51 41 43 41 38 39 41 43 35 38 39 29 29 30
32 32 32 32 32 32 32 32 32 32 32 32 32 32 32 32 32 32 32 32 32 32 32 32 32 32 32 32 32 32 32 32 32 32
31 31 31 31 31 31 31 31 31 31 31 31 31 31 31 31 31 31 31 31 31 31 31 31 31 31 31 31 31 31 31 31 31 31