34 14
57 57 57 57 57 57 57 57 57 57 57 57 57 57 57 57 57 57 57 57 57 57 57 57 57 57 57 57 57 57 57 57 57 57
57 57 57 57 57 57 57 57 57 57 57 57 57 57 57 57 57 62 57 57 57 57 57 57 57 57 57 57 57 62 57 57 57 57
57 57 57 57 57 57 57 57 57 57 57 57 57 57 57 57 57 57 57 57 57 57 57 62 57 57 57 57 57 57 57 57 57 57
57 57 57 57 62 57 57 57 57 57 57 57 57 57 57 57 57 57 57 57 57 57 57 57 57 57 57 57 57 57 57 57 57 57
57 63 64 57 57 57 57 59 60 61 57 57 57 62 57 57 62 57 57 57 62 57 57 63 64 57 57 62 57 57 57 57 57 57
57 65 66 57 57 57 57 57 57 57 57 57 57 57 57 57 57 57 57 57 57 57 57 65 66 57 57 57 57 57 57 57 57 57
57 57 57 57 57 62 57 57 57 57 57 62 57 57 57 57 57 62 57 57 57 57 57 57 57 57 57 57 57 57 62 57 57 57
57 57 57 57 57 57 57 57 62 57 57 72 57 84 85 86 57 57 57 57 57 57 57 57 62 57 57 57 57 57 57 57 57 57
84 85 85 86 57 57 57 57 57 73 57 74 57 57 62 57 57 57 57 57 72 57 84 85 85 86 57 57 57 57 57 57 57 57
57 57 57 57 57 57 69 57 57 75 57 74 57 57 57 69 57 57 57 57 74 57 57 57 57 57 57 57 69 73 57 57 57 57
58 57 57 57 57 57 70 57 57 75 82 74 57 57 57 70 57 82 78 80 74 57 57 82 57 57 78 80 70 75 82 57 57 58
58 57 57 57 57 57 71 57 57 77 83 76 57 57 57 71 57 83 79 81 76 57 57 83 57 57 79 81 71 77 83 57 57 58
68 68 68 68 68 68 68 68 68 68 68 68 68 68 68 68 68 68 68 68 68 68 68 68 68 68 68 68 68 68 68 68 68 68
67 67 67 67 67 67 67 67 67 67 67 67 67 67 67 67 67 67 67 67 67 67 67 67 67 67 67 67 67 67 67 67 67 67